[console_scripts]
deps-rocker = deps_rocker.dep_rocker_cli:gen_dockerfile

[rocker.extensions]
auto = deps_rocker.extensions.auto.auto:Auto
cargo = deps_rocker.extensions.cargo.cargo:Cargo
ccache = deps_rocker.extensions.ccache.ccache:Ccache
claude = deps_rocker.extensions.claude.claude:Claude
codex = deps_rocker.extensions.codex.codex:Codex
conda = deps_rocker.extensions.conda.conda:Conda
curl = deps_rocker.extensions.curl.curl:Curl
cwd = deps_rocker.extensions.cwd.cwd:CWD
cwd_name = deps_rocker.extensions.cwd.cwd:CWDName
deps-devtools = deps_rocker.extensions.deps_devtools.deps_devtools:DepsDevtools
detach = deps_rocker.extensions.detach.detach:Detach
fzf = deps_rocker.extensions.fzf.fzf:Fzf
gemini = deps_rocker.extensions.gemini.gemini:Gemini
git_clone = deps_rocker.extensions.git_clone.git_clone:GitClone
gitui = deps_rocker.extensions.gitui.gitui:GitUI
isaac_sim = deps_rocker.extensions.isaac_sim.isaac_sim:IsaacSim
jquery = deps_rocker.extensions.jquery.jquery:Jquery
lazygit = deps_rocker.extensions.lazygit.lazygit:Lazygit
locales = deps_rocker.extensions.locales.locales:Locales
npm = deps_rocker.extensions.npm.npm:Npm
nvim = deps_rocker.extensions.nvim.nvim:Nvim
odeps_dependencies = deps_rocker.dependencies:Dependencies
palanteer = deps_rocker.extensions.palanteer.palanteer:Palanteer
pixi = deps_rocker.extensions.pixi.pixi:Pixi
ros_jazzy = deps_rocker.extensions.ros_jazzy.ros_jazzy:RosJazzy
spec_kit = deps_rocker.extensions.spec_kit.spec_kit:SpecKit
ssh_client = deps_rocker.extensions.ssh_client.ssh_client:SshClient
tzdata = deps_rocker.extensions.tzdata.tzdata:TzData
urdf_viz = deps_rocker.extensions.urdf_viz.urdf_viz:UrdfViz
uv = deps_rocker.extensions.uv.uv:UV
