[console_scripts]
addpath = skilleter_thingy:addpath.addpath
consolecolours = skilleter_thingy:console_colours.console_colours
ffind = skilleter_thingy:ffind.ffind
ggit = skilleter_thingy:ggit.ggit
ggrep = skilleter_thingy:ggrep.ggrep
git-br = skilleter_thingy:git_br.git_br
git-ca = skilleter_thingy:git_ca.git_ca
git-cleanup = skilleter_thingy:git_cleanup.git_cleanup
git-co = skilleter_thingy:git_co.git_co
git-common = skilleter_thingy:git_common.git_common
git-hold = skilleter_thingy:git_hold.git_hold
git-parent = skilleter_thingy:git_parent.git_parent
git-retag = skilleter_thingy:git_retag.git_retag
git-review = skilleter_thingy:git_review.git_review
git-update = skilleter_thingy:git_update.git_update
git-wt = skilleter_thingy:git_wt.git_wt
gitcmp-helper = skilleter_thingy:gitcmp_helper.gitcmp_helper
gitprompt = skilleter_thingy:gitprompt.gitprompt
linecount = skilleter_thingy:linecount.linecount
multigit = skilleter_thingy:multigit.multigit
py-audit = skilleter_thingy:py_audit.py_audit
readable = skilleter_thingy:readable.readable
remdir = skilleter_thingy:remdir.remdir
rpylint = skilleter_thingy:rpylint.rpylint
strreplace = skilleter_thingy:strreplace.strreplace
tfm = skilleter_thingy:tfm.tfm
tfparse = skilleter_thingy:tfparse.tfparse
trimpath = skilleter_thingy:trimpath.trimpath
venv-create = skilleter_thingy:venv_create.venv_create
xchmod = skilleter_thingy:xchmod.xchmod
yamlcheck = skilleter_thingy:yamlcheck.yamlcheck
