[console_scripts]
osism = osism.main:main

[osism.commands]
apply = osism.commands.apply:Run
baremetal burnin = osism.commands.baremetal:BaremetalBurnIn
baremetal deploy = osism.commands.baremetal:BaremetalDeploy
baremetal list = osism.commands.baremetal:BaremetalList
baremetal ping = osism.commands.baremetal:BaremetalPing
baremetal undeploy = osism.commands.baremetal:BaremetalUndeploy
compose = osism.commands.compose:Run
configuration sync = osism.commands.configuration:Sync
console = osism.commands.console:Run
container = osism.commands.container:Run
docker = osism.commands.container:Run
dump facts = osism.commands.get:Facts
dump inventory = osism.commands.get:Hostvars
get facts = osism.commands.get:Facts
get hosts = osism.commands.get:Hosts
get hostvars = osism.commands.get:Hostvars
get logs ansible = osism.commands.log:Ansible
get logs container = osism.commands.log:Container
get logs file = osism.commands.log:File
get logs opensearch = osism.commands.log:Opensearch
get states = osism.commands.get:States
get status = osism.commands.status:Run
get tasks = osism.commands.get:Tasks
get versions manager = osism.commands.get:VersionsManager
get versions netbox = osism.commands.netbox:Versions
lock = osism.commands.lock:Lock
lock status = osism.commands.lock:LockStatus
log ansible = osism.commands.log:Ansible
log container = osism.commands.log:Container
log file = osism.commands.log:File
log opensearch = osism.commands.log:Opensearch
manage baremetal burnin = osism.commands.baremetal:BaremetalBurnIn
manage baremetal deploy = osism.commands.baremetal:BaremetalDeploy
manage baremetal list = osism.commands.baremetal:BaremetalList
manage baremetal maintenance set = osism.commands.baremetal:BaremetalMaintenanceSet
manage baremetal maintenance unset = osism.commands.baremetal:BaremetalMaintenanceUnset
manage baremetal ping = osism.commands.baremetal:BaremetalPing
manage baremetal undeploy = osism.commands.baremetal:BaremetalUndeploy
manage compute disable = osism.commands.compute:ComputeDisable
manage compute enable = osism.commands.compute:ComputeEnable
manage compute evacuate = osism.commands.compute:ComputeEvacuate
manage compute list = osism.commands.compute:ComputeList
manage compute migrate = osism.commands.compute:ComputeMigrate
manage compute migration list = osism.commands.compute:ComputeMigrationList
manage compute start = osism.commands.compute:ComputeStart
manage compute stop = osism.commands.compute:ComputeStop
manage dnsmasq = osism.commands.manage:Dnsmasq
manage flavors = osism.commands.manage:Flavors
manage image clusterapi = osism.commands.manage:ImageClusterapi
manage image clusterapi gardener = osism.commands.manage:ImageClusterapiGardener
manage image gardenlinux = osism.commands.manage:ImageGardenlinux
manage image octavia = osism.commands.manage:ImageOctavia
manage images = osism.commands.manage:Images
manage netbox = osism.commands.netbox:Manage
manage project create = osism.commands.manage:ProjectCreate
manage project sync = osism.commands.manage:ProjectSync
manage redfish list = osism.commands.redfish:List
manage server list = osism.commands.server:ServerList
manage server migrate = osism.commands.server:ServerMigrate
manage volume list = osism.commands.volume:VolumeList
netbox = osism.commands.netbox:Console
noset bootstrap = osism.commands.noset:NoBootstrap
noset maintenance = osism.commands.noset:NoMaintenance
noset vault password = osism.commands.vault:UnsetPassword
openstack stress = osism.commands.stress:OpenStackStress
reconciler = osism.commands.reconciler:Run
reconciler sync = osism.commands.reconciler:Sync
service = osism.commands.service:Run
set bootstrap = osism.commands.set:Bootstrap
set maintenance = osism.commands.set:Maintenance
set vault password = osism.commands.vault:SetPassword
sonic backup = osism.commands.sonic:Backup
sonic console = osism.commands.sonic:Console
sonic list = osism.commands.sonic:List
sonic load = osism.commands.sonic:Load
sonic reboot = osism.commands.sonic:Reboot
sonic reload = osism.commands.sonic:Reload
sonic reset = osism.commands.sonic:Reset
sonic show = osism.commands.sonic:Show
sonic sync = osism.commands.sync:Sonic
sonic ztp = osism.commands.sonic:Ztp
sync ceph-keys = osism.commands.sync:CephKeys
sync configuration = osism.commands.configuration:Sync
sync dnsmasq = osism.commands.manage:Dnsmasq
sync facts = osism.commands.sync:Facts
sync inventory = osism.commands.reconciler:Sync
sync ironic = osism.commands.netbox:Ironic
sync netbox = osism.commands.netbox:Sync
sync sonic = osism.commands.sync:Sonic
task list = osism.commands.get:Tasks
task revoke = osism.commands.task:Revoke
unlock = osism.commands.lock:Unlock
validate = osism.commands.validate:Run
vault password set = osism.commands.vault:SetPassword
vault password unset = osism.commands.vault:UnsetPassword
vault view = osism.commands.vault:View
wait = osism.commands.wait:Run
worker = osism.commands.worker:Run
